111111111111111111111111111111111
1000CCC0000P000C00000000000000001
1011E0111C111C1110110010101011101
101C00100C1CCC1010101010101010001
101110111C111C1110101010110011101
101000001000101010101010101010001
1011101110111C101011001C101011101
100000000000000000000000000000001
111111111111111011111111111111111
101000001000101010101010101010001
1011101110111C101011001C101011101
100000000000000000000000000000001
111111101111111011111111101111111
101000001000101010101011101010001
1011101110111C101011001C101011101
1000000000000000000000000000000C1
111111111111111111111111111111111